name	taxonomy_id	taxonomy_lvl	kraken_assigned_reads	added_reads	new_est_reads	fraction_total_reads	sample
Bacteria	2	D	168234	214	168448	0.70245	SJ_9_09_2020
Eukaryota	2759	D	21529	64	21593	0.09005	SJ_9_09_2020
Archaea	2157	D	48	0	48	2e-4	SJ_9_09_2020
Viruses	10239	D	49687	24	49711	0.2073	SJ_9_09_2020
Bacteria	2	D	30645	19	30664	0.63235	OC_9_30_2020
Eukaryota	2759	D	1721	8	1729	0.03566	OC_9_30_2020
Archaea	2157	D	11	0	11	2.3e-4	OC_9_30_2020
Viruses	10239	D	16085	2	16087	0.33175	OC_9_30_2020
Viruses	10239	D	161591	33	161624	0.81342	PL_01_04_2021
Bacteria	2	D	33979	22	34001	0.17112	PL_01_04_2021
Eukaryota	2759	D	2451	11	2462	0.01239	PL_01_04_2021
Archaea	2157	D	608	0	608	0.00306	PL_01_04_2021
Viruses	10239	D	34389	9	34398	0.66504	SJ_11_18_2020
Bacteria	2	D	13721	25	13746	0.26576	SJ_11_18_2020
Eukaryota	2759	D	3532	17	3549	0.06862	SJ_11_18_2020
Archaea	2157	D	28	0	28	5.4e-4	SJ_11_18_2020
Bacteria	2	D	89875	76	89951	0.45823	SB_8_13_2020
Eukaryota	2759	D	17313	50	17363	0.08845	SB_8_13_2020
Archaea	2157	D	22	0	22	1.1e-4	SB_8_13_2020
Viruses	10239	D	88911	51	88962	0.45319	SB_8_13_2020
Viruses	10239	D	137440	6	137446	0.73349	HTP_12_04_2020
Bacteria	2	D	25884	18	25902	0.13823	HTP_12_04_2020
Eukaryota	2759	D	23993	25	24018	0.12817	HTP_12_04_2020
Archaea	2157	D	19	0	19	1e-4	HTP_12_04_2020
Bacteria	2	D	111430	163	111593	0.69403	SJ_10_21_2020
Eukaryota	2759	D	1131	18	1149	0.00715	SJ_10_21_2020
Archaea	2157	D	72	0	72	4.5e-4	SJ_10_21_2020
Viruses	10239	D	47954	19	47973	0.29836	SJ_10_21_2020
Bacteria	2	D	610007	353	610360	0.87978	NC_8_28_2020
Eukaryota	2759	D	28568	92	28660	0.04131	NC_8_28_2020
Archaea	2157	D	80	0	80	1.2e-4	NC_8_28_2020
Viruses	10239	D	54644	18	54662	0.07879	NC_8_28_2020
Bacteria	2	D	680995	959	681954	0.96109	JWPCP_9_15_2020
Eukaryota	2759	D	2770	16	2786	0.00393	JWPCP_9_15_2020
Archaea	2157	D	154	0	154	2.2e-4	JWPCP_9_15_2020
Viruses	10239	D	24653	12	24665	0.03476	JWPCP_9_15_2020
Viruses	10239	D	376244	74	376318	0.5794	HTP_2_28_21
Bacteria	2	D	234981	339	235320	0.36231	HTP_2_28_21
Eukaryota	2759	D	37143	345	37488	0.05772	HTP_2_28_21
Archaea	2157	D	363	0	363	5.6e-4	HTP_2_28_21
Bacteria	2	D	18239	19	18258	0.50704	JWPCP_11_3_2020
Eukaryota	2759	D	4479	39	4518	0.12547	JWPCP_11_3_2020
Archaea	2157	D	32	0	32	8.9e-4	JWPCP_11_3_2020
Viruses	10239	D	13199	1	13200	0.36658	JWPCP_11_3_2020
Bacteria	2	D	160492	173	160665	0.60371	HTP_9_08_2020
Eukaryota	2759	D	7036	39	7075	0.02658	HTP_9_08_2020
Archaea	2157	D	56	0	56	2.1e-4	HTP_9_08_2020
Viruses	10239	D	98299	34	98333	0.36949	HTP_9_08_2020
Bacteria	2	D	212312	245	212557	0.68662	HTP_8_25_2020
Eukaryota	2759	D	16670	61	16731	0.05405	HTP_8_25_2020
Archaea	2157	D	82	0	82	2.6e-4	HTP_8_25_2020
Viruses	10239	D	80144	53	80197	0.25906	HTP_8_25_2020
Bacteria	2	D	327885	293	328178	0.9008	OC_9_16_2020
Eukaryota	2759	D	4002	21	4023	0.01104	OC_9_16_2020
Archaea	2157	D	55	0	55	1.5e-4	OC_9_16_2020
Viruses	10239	D	32050	9	32059	0.088	OC_9_16_2020
Viruses	10239	D	519550	48	519598	0.64169	ESC_11_16_20
Bacteria	2	D	272656	444	273100	0.33727	ESC_11_16_20
Eukaryota	2759	D	16570	161	16731	0.02066	ESC_11_16_20
Archaea	2157	D	303	0	303	3.7e-4	ESC_11_16_20
Eukaryota	2759	D	142173	107	142280	0.56001	PL_12_28_2020
Bacteria	2	D	19866	20	19886	0.07827	PL_12_28_2020
Archaea	2157	D	185	0	185	7.3e-4	PL_12_28_2020
Viruses	10239	D	91710	6	91716	0.36099	PL_12_28_2020
Bacteria	2	D	12722	32	12754	0.80436	JWPCP_9_29_2020
Eukaryota	2759	D	738	3	741	0.04673	JWPCP_9_29_2020
Archaea	2157	D	12	0	12	7.6e-4	JWPCP_9_29_2020
Viruses	10239	D	2348	0	2348	0.14808	JWPCP_9_29_2020
Viruses	10239	D	197978	31	198009	0.92403	HTP_11_24_2020
Bacteria	2	D	12486	4	12490	0.05829	HTP_11_24_2020
Eukaryota	2759	D	3745	19	3764	0.01757	HTP_11_24_2020
Archaea	2157	D	24	0	24	1.1e-4	HTP_11_24_2020
Viruses	10239	D	206543	24	206567	0.8404	PL_11_29_2020
Eukaryota	2759	D	29712	40	29752	0.12104	PL_11_29_2020
Bacteria	2	D	9434	7	9441	0.03841	PL_11_29_2020
Archaea	2157	D	36	0	36	1.5e-4	PL_11_29_2020
Bacteria	2	D	922568	582	923150	0.92415	OC_9_03_2020
Eukaryota	2759	D	28478	113	28591	0.02862	OC_9_03_2020
Archaea	2157	D	214	0	214	2.1e-4	OC_9_03_2020
Viruses	10239	D	46935	32	46967	0.04702	OC_9_03_2020
Eukaryota	2759	D	4262212	2611	4264823	0.81256	HTP_4_15_2021
Bacteria	2	D	977605	633	978238	0.18638	HTP_4_15_2021
Archaea	2157	D	360	0	360	7e-5	HTP_4_15_2021
Viruses	10239	D	5189	8	5197	9.9e-4	HTP_4_15_2021
Viruses	10239	D	107584	21	107605	0.89843	SJ_9_23_2020
Bacteria	2	D	11033	12	11045	0.09222	SJ_9_23_2020
Eukaryota	2759	D	1097	8	1105	0.00923	SJ_9_23_2020
Archaea	2157	D	13	0	13	1.1e-4	SJ_9_23_2020
Bacteria	2	D	13524	3	13527	0.50432	OC_8_26_2020
Eukaryota	2759	D	5653	13	5666	0.21124	OC_8_26_2020
Archaea	2157	D	3	0	3	1.1e-4	OC_8_26_2020
Viruses	10239	D	7623	1	7624	0.28424	OC_8_26_2020
Bacteria	2	D	6442351	4009	6446360	0.96666	HTP_1_19_21
Eukaryota	2759	D	39023	421	39444	0.00591	HTP_1_19_21
Archaea	2157	D	1179	2	1181	1.8e-4	HTP_1_19_21
Viruses	10239	D	181648	56	181704	0.02725	HTP_1_19_21
Bacteria	2	D	122787	208	122995	0.69355	SJ_9_16_2020
Eukaryota	2759	D	20515	129	20644	0.11641	SJ_9_16_2020
Archaea	2157	D	88	0	88	5e-4	SJ_9_16_2020
Viruses	10239	D	33601	10	33611	0.18953	SJ_9_16_2020
Bacteria	2	D	214483	70	214553	0.42041	SB_8_27_2020
Eukaryota	2759	D	83011	124	83135	0.1629	SB_8_27_2020
Archaea	2157	D	62	0	62	1.2e-4	SB_8_27_2020
Viruses	10239	D	212461	124	212585	0.41656	SB_8_27_2020
Viruses	10239	D	202383	18	202401	0.9102	HTP_9_29_2020
Bacteria	2	D	18115	19	18134	0.08155	HTP_9_29_2020
Eukaryota	2759	D	1813	13	1826	0.00821	HTP_9_29_2020
Archaea	2157	D	8	0	8	4e-5	HTP_9_29_2020
Bacteria	2	D	6186325	4738	6191063	0.89114	HTP_6_10_2021
Eukaryota	2759	D	112650	504	113154	0.01629	HTP_6_10_2021
Archaea	2157	D	912	0	912	1.3e-4	HTP_6_10_2021
Viruses	10239	D	641971	246	642217	0.09244	HTP_6_10_2021
Eukaryota	2759	D	1934055	1553	1935608	0.63633	ESC_1_25_21
Bacteria	2	D	185640	268	185908	0.06112	ESC_1_25_21
Archaea	2157	D	183	0	183	6e-5	ESC_1_25_21
Viruses	10239	D	919934	198	920132	0.30249	ESC_1_25_21
Eukaryota	2759	D	16172	12	16184	0.44084	JWPCP_8_25_2020
Bacteria	2	D	12075	20	12095	0.32946	JWPCP_8_25_2020
Archaea	2157	D	9	0	9	2.5e-4	JWPCP_8_25_2020
Viruses	10239	D	8421	2	8423	0.22943	JWPCP_8_25_2020
Eukaryota	2759	D	956371	903	957274	0.72808	HTP_2_23_21
Bacteria	2	D	230823	349	231172	0.17582	HTP_2_23_21
Archaea	2157	D	126	0	126	1e-4	HTP_2_23_21
Viruses	10239	D	126178	50	126228	0.09601	HTP_2_23_21
Bacteria	2	D	364606	400	365006	0.56089	HTP_1_24_21
Eukaryota	2759	D	159222	782	160004	0.24587	HTP_1_24_21
Archaea	2157	D	164	0	164	2.5e-4	HTP_1_24_21
Viruses	10239	D	125570	21	125591	0.19299	HTP_1_24_21
Viruses	10239	D	97930	8	97938	0.59121	SJ_8_26_2020
Bacteria	2	D	58323	59	58382	0.35242	SJ_8_26_2020
Eukaryota	2759	D	9197	65	9262	0.05591	SJ_8_26_2020
Archaea	2157	D	74	0	74	4.5e-4	SJ_8_26_2020
Bacteria	2	D	1942853	1112	1943965	0.89699	HTP_3_30_2021
Eukaryota	2759	D	144671	443	145114	0.06696	HTP_3_30_2021
Archaea	2157	D	532	0	532	2.5e-4	HTP_3_30_2021
Viruses	10239	D	77534	57	77591	0.0358	HTP_3_30_2021
Viruses	10239	D	147401	17	147418	0.85945	PL_12_14_2020
Eukaryota	2759	D	13292	28	13320	0.07766	PL_12_14_2020
Bacteria	2	D	10752	8	10760	0.06273	PL_12_14_2020
Archaea	2157	D	26	0	26	1.5e-4	PL_12_14_2020
Bacteria	2	D	10755	6	10761	0.31982	PL_11_5_2020
Eukaryota	2759	D	6890	11	6901	0.2051	PL_11_5_2020
Archaea	2157	D	16	0	16	4.8e-4	PL_11_5_2020
Viruses	10239	D	15963	4	15967	0.47454	PL_11_5_2020
Eukaryota	2759	D	33089	42	33131	0.57223	JWPCP_10_06_2020
Bacteria	2	D	21922	29	21951	0.37913	JWPCP_10_06_2020
Archaea	2157	D	43	0	43	7.4e-4	JWPCP_10_06_2020
Viruses	10239	D	2771	0	2771	0.04786	JWPCP_10_06_2020
Bacteria	2	D	3581717	1316	3583033	0.58089	ESC_4_19_2021
Eukaryota	2759	D	1730202	1932	1732134	0.28082	ESC_4_19_2021
Archaea	2157	D	2229	0	2229	3.6e-4	ESC_4_19_2021
Viruses	10239	D	850482	335	850817	0.13794	ESC_4_19_2021
Bacteria	2	D	13023475	10425	13033900	0.92687	HTP_3_11_21
Eukaryota	2759	D	62715	374	63089	0.00449	HTP_3_11_21
Archaea	2157	D	2849	3	2852	2e-4	HTP_3_11_21
Viruses	10239	D	961757	602	962359	0.06844	HTP_3_11_21
Viruses	10239	D	81075	4	81079	0.73086	SJ_11_11_2020
Bacteria	2	D	25455	21	25476	0.22964	SJ_11_11_2020
Eukaryota	2759	D	4318	39	4357	0.03927	SJ_11_11_2020
Archaea	2157	D	23	0	23	2.1e-4	SJ_11_11_2020
Bacteria	2	D	736526	617	737143	0.65189	ESC_2_8_21
Eukaryota	2759	D	120673	280	120953	0.10696	ESC_2_8_21
Archaea	2157	D	635	0	635	5.6e-4	ESC_2_8_21
Viruses	10239	D	271918	134	272052	0.24059	ESC_2_8_21
Eukaryota	2759	D	107236	109	107345	0.39906	HTP_2_21_21
Bacteria	2	D	86174	107	86281	0.32075	HTP_2_21_21
Archaea	2157	D	36	0	36	1.3e-4	HTP_2_21_21
Viruses	10239	D	75300	30	75330	0.28004	HTP_2_21_21
Bacteria	2	D	12479	31	12510	0.68264	JWPCP_11_10_2020
Eukaryota	2759	D	2407	44	2451	0.13374	JWPCP_11_10_2020
Archaea	2157	D	5	0	5	2.7e-4	JWPCP_11_10_2020
Viruses	10239	D	3358	0	3358	0.18324	JWPCP_11_10_2020
Bacteria	2	D	4414096	3172	4417268	0.90356	HTP_4_22_2021
Eukaryota	2759	D	337323	676	337999	0.06914	HTP_4_22_2021
Archaea	2157	D	505	0	505	1e-4	HTP_4_22_2021
Viruses	10239	D	132924	54	132978	0.0272	HTP_4_22_2021
Viruses	10239	D	788507	127	788634	0.69142	ESC_2_15_21
Eukaryota	2759	D	206991	292	207283	0.18173	ESC_2_15_21
Bacteria	2	D	144395	134	144529	0.12671	ESC_2_15_21
Archaea	2157	D	151	0	151	1.3e-4	ESC_2_15_21
Eukaryota	2759	D	3075868	2706	3078574	0.82214	PL_1_20_21
Bacteria	2	D	602414	493	602907	0.16101	PL_1_20_21
Archaea	2157	D	456	0	456	1.2e-4	PL_1_20_21
Viruses	10239	D	62294	367	62661	0.01673	PL_1_20_21
Bacteria	2	D	5349784	3445	5353229	0.95699	HTP_4_29_2021
Eukaryota	2759	D	132802	363	133165	0.02381	HTP_4_29_2021
Archaea	2157	D	579	0	579	1e-4	HTP_4_29_2021
Viruses	10239	D	106796	56	106852	0.0191	HTP_4_29_2021
Eukaryota	2759	D	1701834	1711	1703545	0.5813	HTP_5_9_2021
Bacteria	2	D	1201121	822	1201943	0.41014	HTP_5_9_2021
Archaea	2157	D	176	0	176	6e-5	HTP_5_9_2021
Viruses	10239	D	24917	10	24927	0.00851	HTP_5_9_2021
Bacteria	2	D	1680551	941	1681492	0.90805	HTP_5_11_2021
Eukaryota	2759	D	128503	338	128841	0.06958	HTP_5_11_2021
Archaea	2157	D	159	0	159	9e-5	HTP_5_11_2021
Viruses	10239	D	41237	22	41259	0.02228	HTP_5_11_2021
Bacteria	2	D	419657	526	420183	0.75751	ESC_8_17_20
Eukaryota	2759	D	71645	341	71986	0.12978	ESC_8_17_20
Archaea	2157	D	568	0	568	0.00102	ESC_8_17_20
Viruses	10239	D	61876	77	61953	0.11169	ESC_8_17_20
Bacteria	2	D	592613	451	593064	0.31409	HTP_3_16_21
Eukaryota	2759	D	401480	601	402081	0.21294	HTP_3_16_21
Archaea	2157	D	468	0	468	2.5e-4	HTP_3_16_21
Viruses	10239	D	892411	179	892590	0.47272	HTP_3_16_21
Eukaryota	2759	D	1314065	1211	1315276	0.86038	HTP_1_26_21
Bacteria	2	D	165500	764	166264	0.10876	HTP_1_26_21
Archaea	2157	D	66	0	66	4e-5	HTP_1_26_21
Viruses	10239	D	47058	42	47100	0.03081	HTP_1_26_21
Eukaryota	2759	D	5165358	3838	5169196	0.78252	PL_6_7_2021
Bacteria	2	D	1169356	2179	1171535	0.17735	PL_6_7_2021
Archaea	2157	D	1266	0	1266	1.9e-4	PL_6_7_2021
Viruses	10239	D	263113	684	263797	0.03993	PL_6_7_2021
Bacteria	2	D	12699090	8491	12707581	0.95153	HTP_5_20_2021
Eukaryota	2759	D	401268	1434	402702	0.03015	HTP_5_20_2021
Archaea	2157	D	1639	1	1640	1.2e-4	HTP_5_20_2021
Viruses	10239	D	242624	307	242931	0.01819	HTP_5_20_2021
Bacteria	2	D	1268971	977	1269948	0.70474	HTP_2_16_21
Eukaryota	2759	D	331969	652	332621	0.18458	HTP_2_16_21
Archaea	2157	D	347	0	347	1.9e-4	HTP_2_16_21
Viruses	10239	D	198993	91	199084	0.11048	HTP_2_16_21
Viruses	10239	D	2213538	201	2213739	0.57178	ESC_5_24_2021
Eukaryota	2759	D	1450105	1125	1451230	0.37484	ESC_5_24_2021
Bacteria	2	D	205935	327	206262	0.05327	ESC_5_24_2021
Archaea	2157	D	415	0	415	1.1e-4	ESC_5_24_2021
Bacteria	2	D	4375529	3013	4378542	0.97596	HTP_5_4_2021
Eukaryota	2759	D	40254	165	40419	0.00901	HTP_5_4_2021
Archaea	2157	D	428	0	428	1e-4	HTP_5_4_2021
Viruses	10239	D	66973	44	67017	0.01494	HTP_5_4_2021
Bacteria	2	D	14169161	8463	14177624	0.98721	HTP_5_31_2021
Eukaryota	2759	D	8536	56	8592	6e-4	HTP_5_31_2021
Archaea	2157	D	1693	1	1694	1.2e-4	HTP_5_31_2021
Viruses	10239	D	173376	77	173453	0.01208	HTP_5_31_2021
Bacteria	2	D	6918212	6155	6924367	0.96708	HTP_5_2_2021
Eukaryota	2759	D	105070	433	105503	0.01473	HTP_5_2_2021
Archaea	2157	D	767	0	767	1.1e-4	HTP_5_2_2021
Viruses	10239	D	129396	65	129461	0.01808	HTP_5_2_2021
Bacteria	2	D	299500	272	299772	0.56059	HTP_3_25_2021
Eukaryota	2759	D	233841	444	234285	0.43813	HTP_3_25_2021
Archaea	2157	D	111	0	111	2.1e-4	HTP_3_25_2021
Viruses	10239	D	567	3	570	0.00107	HTP_3_25_2021
Bacteria	2	D	472831	272	473103	0.47932	HTP_4_25_2021
Eukaryota	2759	D	42661	246	42907	0.04347	HTP_4_25_2021
Archaea	2157	D	370	0	370	3.7e-4	HTP_4_25_2021
Viruses	10239	D	470569	82	470651	0.47683	HTP_4_25_2021
Bacteria	2	D	1721722	820	1722542	0.76942	ESC_10_19_20
Eukaryota	2759	D	388382	809	389191	0.17384	ESC_10_19_20
Archaea	2157	D	2029	0	2029	9.1e-4	ESC_10_19_20
Viruses	10239	D	124856	142	124998	0.05583	ESC_10_19_20
Bacteria	2	D	520545	232	520777	0.88718	OC_9_02_2020
Eukaryota	2759	D	13554	47	13601	0.02317	OC_9_02_2020
Archaea	2157	D	110	0	110	1.9e-4	OC_9_02_2020
Viruses	10239	D	52489	21	52510	0.08945	OC_9_02_2020
Eukaryota	2759	D	20575	28	20603	0.50212	JWPCP_9_22_2020
Bacteria	2	D	15938	20	15958	0.38892	JWPCP_9_22_2020
Archaea	2157	D	29	0	29	7.1e-4	JWPCP_9_22_2020
Viruses	10239	D	4440	0	4440	0.10821	JWPCP_9_22_2020
Bacteria	2	D	187736	356	188092	0.52363	JW_10_27_2020
Eukaryota	2759	D	97155	121	97276	0.27081	JW_10_27_2020
Archaea	2157	D	57	0	57	1.6e-4	JW_10_27_2020
Viruses	10239	D	73766	15	73781	0.2054	JW_10_27_2020
Bacteria	2	D	3763709	2136	3765845	0.95698	PL_2_28_21
Eukaryota	2759	D	55852	271	56123	0.01426	PL_2_28_21
Archaea	2157	D	1430	0	1430	3.6e-4	PL_2_28_21
Viruses	10239	D	111660	94	111754	0.0284	PL_2_28_21
Eukaryota	2759	D	2209916	1837	2211753	0.57996	ESC_3_29_2021
Bacteria	2	D	741503	455	741958	0.19456	ESC_3_29_2021
Archaea	2157	D	542	0	542	1.4e-4	ESC_3_29_2021
Viruses	10239	D	859054	295	859349	0.22534	ESC_3_29_2021
Eukaryota	2759	D	955524	827	956351	0.44993	PL_1_6_21
Bacteria	2	D	615855	495	616350	0.28997	PL_1_6_21
Archaea	2157	D	1619	0	1619	7.6e-4	PL_1_6_21
Viruses	10239	D	551125	106	551231	0.25934	PL_1_6_21
Bacteria	2	D	306388	373	306761	0.54639	JW_10_20_2020
Eukaryota	2759	D	186039	198	186237	0.33172	JW_10_20_2020
Archaea	2157	D	74	0	74	1.3e-4	JW_10_20_2020
Viruses	10239	D	68335	21	68356	0.12175	JW_10_20_2020
Bacteria	2	D	638982	985	639967	0.62061	ESC_8_3_20
Eukaryota	2759	D	25346	288	25634	0.02486	ESC_8_3_20
Archaea	2157	D	705	1	706	6.8e-4	ESC_8_3_20
Viruses	10239	D	364753	126	364879	0.35384	ESC_8_3_20
Bacteria	2	D	100137	140	100277	0.37526	SB_10_22_2020
Eukaryota	2759	D	81347	126	81473	0.30489	SB_10_22_2020
Archaea	2157	D	46	0	46	1.7e-4	SB_10_22_2020
Viruses	10239	D	85399	26	85425	0.31968	SB_10_22_2020
Bacteria	2	D	608723	679	609402	0.35083	HTP_6_20_2021
Eukaryota	2759	D	441199	1110	442309	0.25463	HTP_6_20_2021
Archaea	2157	D	973	0	973	5.6e-4	HTP_6_20_2021
Viruses	10239	D	684268	82	684350	0.39398	HTP_6_20_2021
Bacteria	2	D	114750	133	114883	0.50074	SB_9_10_2020
Eukaryota	2759	D	15391	59	15450	0.06734	SB_9_10_2020
Archaea	2157	D	53	0	53	2.3e-4	SB_9_10_2020
Viruses	10239	D	98985	52	99037	0.43167	SB_9_10_2020
Bacteria	2	D	5981408	3873	5985281	0.79896	HTP_3_14_21
Eukaryota	2759	D	418396	1169	419565	0.05601	HTP_3_14_21
Archaea	2157	D	1321	0	1321	1.8e-4	HTP_3_14_21
Viruses	10239	D	1084735	470	1085205	0.14486	HTP_3_14_21
Eukaryota	2759	D	491063	595	491658	0.64028	PL_2_17_21
Bacteria	2	D	174384	137	174521	0.22728	PL_2_17_21
Archaea	2157	D	905	0	905	0.00118	PL_2_17_21
Viruses	10239	D	100795	4	100799	0.13127	PL_2_17_21
Bacteria	2	D	182390	248	182638	0.77971	HTP_10_02_2020
Eukaryota	2759	D	13948	61	14009	0.05981	HTP_10_02_2020
Archaea	2157	D	91	0	91	3.9e-4	HTP_10_02_2020
Viruses	10239	D	37470	29	37499	0.16009	HTP_10_02_2020
Bacteria	2	D	16416905	10538	16427443	0.95	HTP_5_16_2021
Eukaryota	2759	D	566161	1709	567870	0.03284	HTP_5_16_2021
Archaea	2157	D	2226	1	2227	1.3e-4	HTP_5_16_2021
Viruses	10239	D	294122	319	294441	0.01703	HTP_5_16_2021
Bacteria	2	D	2544507	1580	2546087	0.79139	ESC_11_2_20
Eukaryota	2759	D	432118	1560	433678	0.1348	ESC_11_2_20
Archaea	2157	D	5292	1	5293	0.00165	ESC_11_2_20
Viruses	10239	D	231630	533	232163	0.07216	ESC_11_2_20
Bacteria	2	D	8047	4	8051	0.39965	PL_10_22_2020
Eukaryota	2759	D	7634	15	7649	0.3797	PL_10_22_2020
Archaea	2157	D	14	0	14	6.9e-4	PL_10_22_2020
Viruses	10239	D	4430	0	4430	0.21991	PL_10_22_2020
Bacteria	2	D	1952429	1115	1953544	0.62879	ESC_3_1_21
Eukaryota	2759	D	716214	972	717186	0.23084	ESC_3_1_21
Archaea	2157	D	830	0	830	2.7e-4	ESC_3_1_21
Viruses	10239	D	435032	218	435250	0.1401	ESC_3_1_21
Bacteria	2	D	2067750	1450	2069200	0.76606	HTP_3_9_21
Eukaryota	2759	D	221564	608	222172	0.08225	HTP_3_9_21
Archaea	2157	D	595	0	595	2.2e-4	HTP_3_9_21
Viruses	10239	D	408963	156	409119	0.15146	HTP_3_9_21
Eukaryota	2759	D	319981	398	320379	0.46638	ESC_12_14_20
Bacteria	2	D	263683	255	263938	0.38422	ESC_12_14_20
Archaea	2157	D	301	0	301	4.4e-4	ESC_12_14_20
Viruses	10239	D	102295	31	102326	0.14896	ESC_12_14_20
Eukaryota	2759	D	6400288	3224	6403512	0.9501	PL_3_18_2021
Bacteria	2	D	283592	175	283767	0.0421	PL_3_18_2021
Archaea	2157	D	249	0	249	4e-5	PL_3_18_2021
Viruses	10239	D	52283	11	52294	0.00776	PL_3_18_2021
Bacteria	2	D	39979	63	40042	0.33985	HTP_8_11_2020
Eukaryota	2759	D	28312	67	28379	0.24087	HTP_8_11_2020
Archaea	2157	D	37	0	37	3.1e-4	HTP_8_11_2020
Viruses	10239	D	49357	5	49362	0.41896	HTP_8_11_2020
Eukaryota	2759	D	745919	789	746708	0.43806	PL_2_3_21
Bacteria	2	D	676699	425	677124	0.39724	PL_2_3_21
Archaea	2157	D	910	0	910	5.3e-4	PL_2_3_21
Viruses	10239	D	279779	39	279818	0.16416	PL_2_3_21
Bacteria	2	D	1909507	1140	1910647	0.66511	ESC_2_22_21
Eukaryota	2759	D	616006	807	616813	0.21472	ESC_2_22_21
Archaea	2157	D	868	0	868	3e-4	ESC_2_22_21
Viruses	10239	D	344249	115	344364	0.11987	ESC_2_22_21
Bacteria	2	D	1489621	1101	1490722	0.69407	HTP_3_29_2021
Eukaryota	2759	D	575867	1020	576887	0.2686	HTP_3_29_2021
Archaea	2157	D	348	0	348	1.6e-4	HTP_3_29_2021
Viruses	10239	D	79801	35	79836	0.03717	HTP_3_29_2021
Bacteria	2	D	1348325	2903	1351228	0.50822	HTP_6_24_2021
Eukaryota	2759	D	664652	1289	665941	0.25047	HTP_6_24_2021
Archaea	2157	D	1092	0	1092	4.1e-4	HTP_6_24_2021
Viruses	10239	D	639934	573	640507	0.2409	HTP_6_24_2021
Viruses	10239	D	245421	34	245455	0.56045	ESC_1_11_21
Bacteria	2	D	138100	216	138316	0.31582	ESC_1_11_21
Eukaryota	2759	D	53684	295	53979	0.12325	ESC_1_11_21
Archaea	2157	D	210	0	210	4.8e-4	ESC_1_11_21
Viruses	10239	D	167995	32	168027	0.87252	PL_01_03_2021
Bacteria	2	D	22660	11	22671	0.11772	PL_01_03_2021
Eukaryota	2759	D	1513	5	1518	0.00788	PL_01_03_2021
Archaea	2157	D	359	0	359	0.0018600000000000001	PL_01_03_2021
Viruses	10239	D	219595	29	219624	0.90346	OC_11_11_2020
Bacteria	2	D	20244	29	20273	0.0834	OC_11_11_2020
Eukaryota	2759	D	3144	16	3160	0.013	OC_11_11_2020
Archaea	2157	D	35	0	35	1.4e-4	OC_11_11_2020
Bacteria	2	D	5794963	1829	5796792	0.92459	HTP_4_8_2021
Eukaryota	2759	D	377841	1431	379272	0.06049	HTP_4_8_2021
Archaea	2157	D	667	0	667	1.1e-4	HTP_4_8_2021
Viruses	10239	D	92837	27	92864	0.01481	HTP_4_8_2021
Bacteria	2	D	6676906	3286	6680192	0.98616	PL_4_4_2021
Eukaryota	2759	D	20832	173	21005	0.0031	PL_4_4_2021
Archaea	2157	D	3701	2	3703	5.5e-4	PL_4_4_2021
Viruses	10239	D	69016	34	69050	0.01019	PL_4_4_2021
Bacteria	2	D	1311805	523	1312328	0.50996	PL_1_17_21
Eukaryota	2759	D	1228623	1647	1230270	0.47807	PL_1_17_21
Archaea	2157	D	1086	0	1086	4.2e-4	PL_1_17_21
Viruses	10239	D	29709	9	29718	0.01155	PL_1_17_21
Bacteria	2	D	158545	200	158745	0.75856	HTP_10_13_2020
Eukaryota	2759	D	4907	36	4943	0.02362	HTP_10_13_2020
Archaea	2157	D	67	0	67	3.2e-4	HTP_10_13_2020
Viruses	10239	D	45498	18	45516	0.2175	HTP_10_13_2020
Bacteria	2	D	10876035	8562	10884597	0.88926	HTP_3_4_21
Eukaryota	2759	D	58016	344	58360	0.00477	HTP_3_4_21
Archaea	2157	D	2301	2	2303	1.9e-4	HTP_3_4_21
Viruses	10239	D	1294154	629	1294783	0.10578	HTP_3_4_21
Bacteria	2	D	8364818	3251	8368069	0.96284	HTP_4_4_2021
Eukaryota	2759	D	214042	1160	215202	0.02476	HTP_4_4_2021
Archaea	2157	D	1040	0	1040	1.2e-4	HTP_4_4_2021
Viruses	10239	D	106680	31	106711	0.01228	HTP_4_4_2021
Bacteria	2	D	5403286	4625	5407911	0.82951	HTP_6_15_2021
Eukaryota	2759	D	149469	516	149985	0.02301	HTP_6_15_2021
Archaea	2157	D	761	0	761	1.2e-4	HTP_6_15_2021
Viruses	10239	D	960457	263	960720	0.14736	HTP_6_15_2021
Bacteria	2	D	4429114	2439	4431553	0.81813	ESC_4_12_2021
Eukaryota	2759	D	332525	773	333298	0.06153	ESC_4_12_2021
Archaea	2157	D	3338	0	3338	6.2e-4	ESC_4_12_2021
Viruses	10239	D	648226	270	648496	0.11972	ESC_4_12_2021
Eukaryota	2759	D	60178	73	60251	0.73057	JWPCP_11_17_2020
Bacteria	2	D	13006	9	13015	0.15781	JWPCP_11_17_2020
Archaea	2157	D	18	0	18	2.2e-4	JWPCP_11_17_2020
Viruses	10239	D	9185	0	9185	0.11137	JWPCP_11_17_2020
Bacteria	2	D	95960	171	96131	0.61017	SJ_10_28_2020
Eukaryota	2759	D	9113	138	9251	0.05872	SJ_10_28_2020
Archaea	2157	D	174	0	174	0.0011	SJ_10_28_2020
Viruses	10239	D	51984	8	51992	0.33001	SJ_10_28_2020
Bacteria	2	D	9501538	5186	9506724	0.97771	HTP_2_4_21
Eukaryota	2759	D	75515	581	76096	0.00783	HTP_2_4_21
Archaea	2157	D	1221	1	1222	1.3e-4	HTP_2_4_21
Viruses	10239	D	139359	66	139425	0.01434	HTP_2_4_21
Eukaryota	2759	D	297917	438	298355	0.3427	ESC_8_31_20
Bacteria	2	D	142019	136	142155	0.16328	ESC_8_31_20
Archaea	2157	D	271	0	271	3.1e-4	ESC_8_31_20
Viruses	10239	D	429792	28	429820	0.49370000000000003	ESC_8_31_20
Bacteria	2	D	21750	15	21765	0.30508	NC_10_09_2020
Eukaryota	2759	D	19796	26	19822	0.27784	NC_10_09_2020
Archaea	2157	D	4	0	4	6e-5	NC_10_09_2020
Viruses	10239	D	29751	0	29751	0.41701	NC_10_09_2020
Bacteria	2	D	494669	621	495290	0.7035	NC_10_23_2020
Eukaryota	2759	D	9105	29	9134	0.01297	NC_10_23_2020
Archaea	2157	D	49	0	49	7e-5	NC_10_23_2020
Viruses	10239	D	199523	37	199560	0.28345	NC_10_23_2020
Viruses	10239	D	58760	13	58773	0.63605	HTP_9_15_2020
Bacteria	2	D	27257	65	27322	0.29568	HTP_9_15_2020
Eukaryota	2759	D	6185	75	6260	0.06775	HTP_9_15_2020
Archaea	2157	D	47	0	47	5.1e-4	HTP_9_15_2020
Bacteria	2	D	6766908	2509	6769417	0.91091	HTP_4_6_2021
Eukaryota	2759	D	531254	1486	532740	0.07169	HTP_4_6_2021
Archaea	2157	D	1018	0	1018	1.4e-4	HTP_4_6_2021
Viruses	10239	D	128239	98	128337	0.01727	HTP_4_6_2021
Bacteria	2	D	4609842	2600	4612442	0.96301	PL_3_31_2021
Eukaryota	2759	D	15922	232	16154	0.00337	PL_3_31_2021
Archaea	2157	D	3328	3	3331	7e-4	PL_3_31_2021
Viruses	10239	D	157594	68	157662	0.03292	PL_3_31_2021
Bacteria	2	D	1896578	890	1897468	0.70673	PL_1_31_21
Eukaryota	2759	D	333462	644	334106	0.12444	PL_1_31_21
Archaea	2157	D	2893	0	2893	0.00108	PL_1_31_21
Viruses	10239	D	450263	135	450398	0.16775	PL_1_31_21
Bacteria	2	D	276199	163	276362	0.80299	SJ_9_02_2020
Eukaryota	2759	D	18142	46	18188	0.05285	SJ_9_02_2020
Archaea	2157	D	38	0	38	1.1e-4	SJ_9_02_2020
Viruses	10239	D	49567	12	49579	0.14405	SJ_9_02_2020
Eukaryota	2759	D	782554	983	783537	0.59156	PL_5_17_2021
Bacteria	2	D	164161	198	164359	0.12409	PL_5_17_2021
Archaea	2157	D	1956	0	1956	0.00148	PL_5_17_2021
Viruses	10239	D	374654	13	374667	0.28287	PL_5_17_2021
Bacteria	2	D	3624900	3284	3628184	0.89605	PL_4_26_2021
Eukaryota	2759	D	8995	57	9052	0.00224	PL_4_26_2021
Archaea	2157	D	2827	1	2828	7e-4	PL_4_26_2021
Viruses	10239	D	408942	72	409014	0.10101	PL_4_26_2021
Bacteria	2	D	111172	111	111283	0.48247	HTP_9_01_2020
Eukaryota	2759	D	9859	44	9903	0.04293	HTP_9_01_2020
Archaea	2157	D	78	0	78	3.4e-4	HTP_9_01_2020
Viruses	10239	D	109362	26	109388	0.47425	HTP_9_01_2020
Viruses	10239	D	164520	10	164530	0.89404	OC_12_21_2020
Bacteria	2	D	10241	16	10257	0.05574	OC_12_21_2020
Eukaryota	2759	D	9207	14	9221	0.05011	OC_12_21_2020
Archaea	2157	D	20	0	20	1.1e-4	OC_12_21_2020
Bacteria	2	D	26493	14	26507	0.5177	OC_9_23_2020
Eukaryota	2759	D	9744	24	9768	0.19078	OC_9_23_2020
Archaea	2157	D	13	0	13	2.5e-4	OC_9_23_2020
Viruses	10239	D	14908	3	14911	0.29122	OC_9_23_2020
Bacteria	2	D	147244	131	147375	0.67398	SJ_8_19_2020
Eukaryota	2759	D	5433	33	5466	0.025	SJ_8_19_2020
Archaea	2157	D	37	0	37	1.7e-4	SJ_8_19_2020
Viruses	10239	D	65765	20	65785	0.30085	SJ_8_19_2020
Bacteria	2	D	2439900	1592	2441492	0.87837	HTP_3_18_2021
Eukaryota	2759	D	206700	779	207479	0.07464	HTP_3_18_2021
Archaea	2157	D	575	0	575	2.1e-4	HTP_3_18_2021
Viruses	10239	D	129957	61	130018	0.04678	HTP_3_18_2021
Viruses	10239	D	261429	41	261470	0.96799	SB_10_08_2020
Bacteria	2	D	7287	3	7290	0.02699	SB_10_08_2020
Eukaryota	2759	D	1342	7	1349	0.00499	SB_10_08_2020
Archaea	2157	D	6	0	6	2e-5	SB_10_08_2020
Bacteria	2	D	831945	1315	833260	0.67319	ESC_4_5_2021
Eukaryota	2759	D	78308	453	78761	0.06363	ESC_4_5_2021
Archaea	2157	D	539	0	539	4.4e-4	ESC_4_5_2021
Viruses	10239	D	325118	102	325220	0.26274	ESC_4_5_2021
Bacteria	2	D	13954965	7360	13962325	0.98602	HTP_5_25_2021
Eukaryota	2759	D	8046	68	8114	5.7e-4	HTP_5_25_2021
Archaea	2157	D	1939	2	1941	1.4e-4	HTP_5_25_2021
Viruses	10239	D	187740	186	187926	0.01327	HTP_5_25_2021
Bacteria	2	D	249208	183	249391	0.56517	HTP_10_27_2020
Eukaryota	2759	D	48595	91	48686	0.11033	HTP_10_27_2020
Archaea	2157	D	63	0	63	1.4e-4	HTP_10_27_2020
Viruses	10239	D	143105	23	143128	0.32436	HTP_10_27_2020
Bacteria	2	D	1878658	1582	1880240	0.74714	PL_5_5_2021
Eukaryota	2759	D	24507	193	24700	0.00981	PL_5_5_2021
Archaea	2157	D	2223	1	2224	8.8e-4	PL_5_5_2021
Viruses	10239	D	609361	51	609412	0.24216	PL_5_5_2021
Viruses	10239	D	175836	20	175856	0.93389	OC_12_14_2020
Bacteria	2	D	8105	8	8113	0.04308	OC_12_14_2020
Eukaryota	2759	D	4296	14	4310	0.02289	OC_12_14_2020
Archaea	2157	D	25	0	25	1.3e-4	OC_12_14_2020
Viruses	10239	D	646935	84	647019	0.53459	PL_1_13_21
Bacteria	2	D	388196	333	388529	0.32102	PL_1_13_21
Eukaryota	2759	D	173681	287	173968	0.14374	PL_1_13_21
Archaea	2157	D	794	0	794	6.6e-4	PL_1_13_21
Bacteria	2	D	358171	233	358404	0.93729	PL_9_10_2020
Eukaryota	2759	D	2468	13	2481	0.00649	PL_9_10_2020
Archaea	2157	D	72	0	72	1.9e-4	PL_9_10_2020
Viruses	10239	D	21422	4	21426	0.05603	PL_9_10_2020
Bacteria	2	D	2522050	1441	2523491	0.56037	PL_5_24_2021
Eukaryota	2759	D	502426	818	503244	0.11175	PL_5_24_2021
Archaea	2157	D	2643	0	2643	5.9e-4	PL_5_24_2021
Viruses	10239	D	1473720	153	1473873	0.32729	PL_5_24_2021
Viruses	10239	D	592797	103	592900	0.50214	ESC_10_26_20
Bacteria	2	D	428229	519	428748	0.36312	ESC_10_26_20
Eukaryota	2759	D	158035	513	158548	0.13428	ESC_10_26_20
Archaea	2157	D	549	0	549	4.6e-4	ESC_10_26_20
Eukaryota	2759	D	5459001	3469	5462470	0.90218	ESC_11_30_20
Bacteria	2	D	328813	609	329422	0.05441	ESC_11_30_20
Archaea	2157	D	88	0	88	1e-5	ESC_11_30_20
Viruses	10239	D	262784	10	262794	0.0434	ESC_11_30_20
Eukaryota	2759	D	1162598	1159	1163757	0.82105	HTP_3_23_2021
Bacteria	2	D	252592	179	252771	0.17833	HTP_3_23_2021
Archaea	2157	D	141	0	141	1e-4	HTP_3_23_2021
Viruses	10239	D	717	14	731	5.2e-4	HTP_3_23_2021
Viruses	10239	D	1522806	247	1523053	0.61678	HTP_7_22_2021
Bacteria	2	D	889708	1102	890810	0.36074	HTP_7_22_2021
Eukaryota	2759	D	54052	551	54603	0.02211	HTP_7_22_2021
Archaea	2157	D	911	0	911	3.7e-4	HTP_7_22_2021
Bacteria	2	D	436666	376	437042	0.78998	JWPCP_9_08_2020
Eukaryota	2759	D	1199	8	1207	0.00218	JWPCP_9_08_2020
Archaea	2157	D	120	0	120	2.2e-4	JWPCP_9_08_2020
Viruses	10239	D	114849	14	114863	0.20762	JWPCP_9_08_2020
Bacteria	2	D	4780058	4203	4784261	0.85735	HTP_3_7_21
Eukaryota	2759	D	69024	366	69390	0.01243	HTP_3_7_21
Archaea	2157	D	1313	1	1314	2.4e-4	HTP_3_7_21
Viruses	10239	D	725011	310	725321	0.12998	HTP_3_7_21
Bacteria	2	D	5008885	4301	5013186	0.91323	PL_5_9_2021
Eukaryota	2759	D	13317	81	13398	0.00244	PL_5_9_2021
Archaea	2157	D	3174	1	3175	5.8e-4	PL_5_9_2021
Viruses	10239	D	459655	70	459725	0.08375	PL_5_9_2021
Bacteria	2	D	109283	94	109377	0.52131	HTP_8_18_2020
Eukaryota	2759	D	28705	83	28788	0.13721	HTP_8_18_2020
Archaea	2157	D	54	0	54	2.6e-4	HTP_8_18_2020
Viruses	10239	D	71558	34	71592	0.34122	HTP_8_18_2020
Bacteria	2	D	1144110	776	1144886	0.55478	HTP_1_10_21
Eukaryota	2759	D	351528	573	352101	0.17062	HTP_1_10_21
Archaea	2157	D	340	0	340	1.6e-4	HTP_1_10_21
Viruses	10239	D	566132	198	566330	0.27443	HTP_1_10_21
Bacteria	2	D	7605059	6767	7611826	0.91325	HTP_6_27_2021
Eukaryota	2759	D	53473	304	53777	0.00645	HTP_6_27_2021
Archaea	2157	D	1296	0	1296	1.6e-4	HTP_6_27_2021
Viruses	10239	D	667855	109	667964	0.08014	HTP_6_27_2021
Bacteria	2	D	680182	605	680787	0.71425	PL_4_25_2021
Eukaryota	2759	D	5711	45	5756	0.00604	PL_4_25_2021
Archaea	2157	D	1344	1	1345	0.00141	PL_4_25_2021
Viruses	10239	D	265238	28	265266	0.2783	PL_4_25_2021
Bacteria	2	D	1881804	2239	1884043	0.93426	PL_3_8_2021
Eukaryota	2759	D	7196	87	7283	0.00361	PL_3_8_2021
Archaea	2157	D	1232	2	1234	6.1e-4	PL_3_8_2021
Viruses	10239	D	123981	76	124057	0.06152	PL_3_8_2021
Bacteria	2	D	1281174	1103	1282277	0.87591	PL_3_1_21
Eukaryota	2759	D	93823	518	94341	0.06444	PL_3_1_21
Archaea	2157	D	1339	1	1340	9.2e-4	PL_3_1_21
Viruses	10239	D	85947	37	85984	0.05873	PL_3_1_21
Bacteria	2	D	7515136	6178	7521314	0.8858	HTP_7_1_2021
Eukaryota	2759	D	216573	856	217429	0.02561	HTP_7_1_2021
Archaea	2157	D	1412	0	1412	1.7e-4	HTP_7_1_2021
Viruses	10239	D	750602	216	750818	0.08843	HTP_7_1_2021
Eukaryota	2759	D	2228447	1829	2230276	0.68976	PL_4_7_2021
Bacteria	2	D	561781	555	562336	0.17391	PL_4_7_2021
Archaea	2157	D	296	0	296	9e-5	PL_4_7_2021
Viruses	10239	D	440392	107	440499	0.13623	PL_4_7_2021
Viruses	10239	D	167730	17	167747	0.8593	PL_11_30_2020
Eukaryota	2759	D	22343	9	22352	0.1145	PL_11_30_2020
Bacteria	2	D	5081	1	5082	0.02603	PL_11_30_2020
Archaea	2157	D	31	0	31	1.6e-4	PL_11_30_2020
Bacteria	2	D	123648	119	123767	0.60871	PL_2_14_21
Eukaryota	2759	D	48435	103	48538	0.23872	PL_2_14_21
Archaea	2157	D	143	0	143	7e-4	PL_2_14_21
Viruses	10239	D	30876	3	30879	0.15187	PL_2_14_21
Bacteria	2	D	90325	100	90425	0.57177	PL_2_8_21
Eukaryota	2759	D	48446	108	48554	0.30701	PL_2_8_21
Archaea	2157	D	157	0	157	9.9e-4	PL_2_8_21
Viruses	10239	D	19010	2	19012	0.12021	PL_2_8_21
Bacteria	2	D	16147483	11436	16158919	0.98385	HTP_6_1_2021
Eukaryota	2759	D	6268	39	6307	3.8e-4	HTP_6_1_2021
Archaea	2157	D	2559	2	2561	1.6e-4	HTP_6_1_2021
Viruses	10239	D	256218	187	256405	0.01561	HTP_6_1_2021
Eukaryota	2759	D	4637710	3509	4641219	0.73695	PL_1_25_21
Bacteria	2	D	1646690	1943	1648633	0.26178	PL_1_25_21
Archaea	2157	D	1978	0	1978	3.1e-4	PL_1_25_21
Viruses	10239	D	5931	96	6027	9.6e-4	PL_1_25_21
Bacteria	2	D	102763	87	102850	0.34484	SJ_8_12_2020
Eukaryota	2759	D	46208	107	46315	0.15529	SJ_8_12_2020
Archaea	2157	D	51	0	51	1.7e-4	SJ_8_12_2020
Viruses	10239	D	148983	50	149033	0.49969	SJ_8_12_2020
Bacteria	2	D	219506	323	219829	0.8343	HTP_10_20_2020
Eukaryota	2759	D	10096	45	10141	0.03849	HTP_10_20_2020
Archaea	2157	D	76	0	76	2.9e-4	HTP_10_20_2020
Viruses	10239	D	33423	19	33442	0.12692	HTP_10_20_2020
Bacteria	2	D	3790701	3370	3794071	0.83625	HTP_1_5_21
Eukaryota	2759	D	207123	737	207860	0.04581	HTP_1_5_21
Archaea	2157	D	951	0	951	2.1e-4	HTP_1_5_21
Viruses	10239	D	533905	217	534122	0.11773	HTP_1_5_21
Eukaryota	2759	D	47882	171	48053	0.58157	PL_8_13_2020
Bacteria	2	D	21326	69	21395	0.25893	PL_8_13_2020
Archaea	2157	D	40	0	40	4.8e-4	PL_8_13_2020
Viruses	10239	D	13135	2	13137	0.15899	PL_8_13_2020
Bacteria	2	D	193373	159	193532	0.6089	SJ_10_07_2020
Eukaryota	2759	D	30350	103	30453	0.09581	SJ_10_07_2020
Archaea	2157	D	106	0	106	3.3e-4	SJ_10_07_2020
Viruses	10239	D	93720	27	93747	0.29495	SJ_10_07_2020
Bacteria	2	D	5702511	6946	5709457	0.92832	HTP_1_7_21
Eukaryota	2759	D	192462	646	193108	0.0314	HTP_1_7_21
Archaea	2157	D	952	0	952	1.5e-4	HTP_1_7_21
Viruses	10239	D	246483	285	246768	0.04012	HTP_1_7_21
Bacteria	2	D	10260	0	10260	0.40133	PL_8_27_2020
Eukaryota	2759	D	6292	12	6304	0.24659	PL_8_27_2020
Archaea	2157	D	12	0	12	4.7e-4	PL_8_27_2020
Viruses	10239	D	8989	0	8989	0.35161	PL_8_27_2020
Eukaryota	2759	D	726759	199	726958	0.85294	PL_4_5_2021
Bacteria	2	D	111971	78	112049	0.13147	PL_4_5_2021
Archaea	2157	D	69	0	69	8e-5	PL_4_5_2021
Viruses	10239	D	13221	1	13222	0.01551	PL_4_5_2021
Bacteria	2	D	5000366	6357	5006723	0.83195	HTP_7_29_2021
Eukaryota	2759	D	225782	832	226614	0.03766	HTP_7_29_2021
Archaea	2157	D	7006	2	7008	0.00116	HTP_7_29_2021
Viruses	10239	D	777392	330	777722	0.12923	HTP_7_29_2021
Viruses	10239	D	131079	8	131087	0.89385	HTP_12_22_2020
Bacteria	2	D	7965	4	7969	0.05434	HTP_12_22_2020
Eukaryota	2759	D	7548	25	7573	0.05164	HTP_12_22_2020
Archaea	2157	D	23	0	23	1.6e-4	HTP_12_22_2020
Bacteria	2	D	213251	325	213576	0.72028	PL_2_22_21
Eukaryota	2759	D	24704	241	24945	0.08413	PL_2_22_21
Archaea	2157	D	441	0	441	0.00149	PL_2_22_21
Viruses	10239	D	57520	35	57555	0.1941	PL_2_22_21
Viruses	10239	D	217737	16	217753	0.50633	PL_5_3_2021
Bacteria	2	D	117839	97	117936	0.27423	PL_5_3_2021
Eukaryota	2759	D	92319	157	92476	0.21503	PL_5_3_2021
Archaea	2157	D	1898	0	1898	0.00441	PL_5_3_2021
Viruses	10239	D	204766	14	204780	0.96075	HTP_01_03_2021
Bacteria	2	D	7309	3	7312	0.03431	HTP_01_03_2021
Eukaryota	2759	D	1026	12	1038	0.00487	HTP_01_03_2021
Archaea	2157	D	14	0	14	7e-5	HTP_01_03_2021
Eukaryota	2759	D	6905159	4209	6909368	0.93696	ESC_1_4_21
Bacteria	2	D	460333	585	460918	0.0625	ESC_1_4_21
Archaea	2157	D	74	0	74	1e-5	ESC_1_4_21
Viruses	10239	D	3814	55	3869	5.2e-4	ESC_1_4_21
Viruses	10239	D	24472	8	24480	0.50251	OC_8_19_2020
Bacteria	2	D	12776	12	12788	0.26251	OC_8_19_2020
Eukaryota	2759	D	11403	37	11440	0.23484	OC_8_19_2020
Archaea	2157	D	6	0	6	1.2e-4	OC_8_19_2020
Viruses	10239	D	2119865	408	2120273	0.9101	ESC_7_5_2021
Bacteria	2	D	161432	340	161772	0.06944	ESC_7_5_2021
Eukaryota	2759	D	46956	315	47271	0.02029	ESC_7_5_2021
Archaea	2157	D	404	0	404	1.7e-4	ESC_7_5_2021
Bacteria	2	D	170082	80	170162	0.4901	OC_10_07_2020
Eukaryota	2759	D	22637	48	22685	0.06534	OC_10_07_2020
Archaea	2157	D	42	0	42	1.2e-4	OC_10_07_2020
Viruses	10239	D	154263	48	154311	0.44444	OC_10_07_2020
Eukaryota	2759	D	442021	273	442294	0.86772	PL_9_24_2020
Bacteria	2	D	60886	38	60924	0.11952	PL_9_24_2020
Archaea	2157	D	103	0	103	2e-4	PL_9_24_2020
Viruses	10239	D	6398	0	6398	0.01255	PL_9_24_2020
Bacteria	2	D	26483	20	26503	0.41031	JWPCP_8_11_2020
Eukaryota	2759	D	16751	30	16781	0.2598	JWPCP_8_11_2020
Archaea	2157	D	24	0	24	3.7e-4	JWPCP_8_11_2020
Viruses	10239	D	21282	1	21283	0.32949	JWPCP_8_11_2020
Viruses	10239	D	725378	23	725401	0.73394	PL_8_3_2021
Bacteria	2	D	201225	361	201586	0.20396	PL_8_3_2021
Eukaryota	2759	D	54845	363	55208	0.05586	PL_8_3_2021
Archaea	2157	D	6165	3	6168	0.00624	PL_8_3_2021
Bacteria	2	D	1241790	664	1242454	0.78156	PL_3_28_2021
Eukaryota	2759	D	293508	607	294115	0.18501	PL_3_28_2021
Archaea	2157	D	3134	0	3134	0.00197	PL_3_28_2021
Viruses	10239	D	49985	14	49999	0.03145	PL_3_28_2021
Eukaryota	2759	D	383151	897	384048	0.30664	ESC_12_7_20
Bacteria	2	D	355661	694	356355	0.28453	ESC_12_7_20
Archaea	2157	D	281	0	281	2.2e-4	ESC_12_7_20
Viruses	10239	D	511676	87	511763	0.40861	ESC_12_7_20
Bacteria	2	D	16573928	12384	16586312	0.98537	HTP_5_23_2021
Eukaryota	2759	D	8196	56	8252	4.9e-4	HTP_5_23_2021
Archaea	2157	D	2248	2	2250	1.3e-4	HTP_5_23_2021
Viruses	10239	D	235688	136	235824	0.01401	HTP_5_23_2021
Bacteria	2	D	10958471	5748	10964219	0.78319	HTP_6_6_2021
Eukaryota	2759	D	2577177	3542	2580719	0.18435000000000001	HTP_6_6_2021
Archaea	2157	D	1485	0	1485	1.1e-4	HTP_6_6_2021
Viruses	10239	D	452044	902	452946	0.03235	HTP_6_6_2021
Bacteria	2	D	6238275	8328	6246603	0.84348	PL_7_12_2021
Eukaryota	2759	D	61896	259	62155	0.00839	PL_7_12_2021
Archaea	2157	D	3396	1	3397	4.6e-4	PL_7_12_2021
Viruses	10239	D	1093386	191	1093577	0.14767	PL_7_12_2021
Eukaryota	2759	D	1657985	1416	1659401	0.70572	ESC_4_26_2021
Bacteria	2	D	595628	368	595996	0.25347	ESC_4_26_2021
Archaea	2157	D	259	0	259	1.1e-4	ESC_4_26_2021
Viruses	10239	D	95693	24	95717	0.04071	ESC_4_26_2021
Bacteria	2	D	315609	188	315797	0.52323	PL_4_21_2021
Eukaryota	2759	D	199553	335	199888	0.33119	PL_4_21_2021
Archaea	2157	D	656	0	656	0.00109	PL_4_21_2021
Viruses	10239	D	87206	3	87209	0.14449	PL_4_21_2021
Viruses	10239	D	3376945	366	3377311	0.96324	ESC_12_28_20
Bacteria	2	D	64566	64	64630	0.01843	ESC_12_28_20
Eukaryota	2759	D	63811	211	64022	0.01826	ESC_12_28_20
Archaea	2157	D	236	0	236	7e-5	ESC_12_28_20
Viruses	10239	D	172133	12	172145	0.95013	HTP_11_3_2020
Bacteria	2	D	7392	7	7399	0.04084	HTP_11_3_2020
Eukaryota	2759	D	1590	13	1603	0.00885	HTP_11_3_2020
Archaea	2157	D	32	0	32	1.8e-4	HTP_11_3_2020
Bacteria	2	D	11589544	5767	11595311	0.94454	PL_6_2_2021
Eukaryota	2759	D	299859	1288	301147	0.02453	PL_6_2_2021
Archaea	2157	D	2510	1	2511	2e-4	PL_6_2_2021
Viruses	10239	D	376865	291	377156	0.03072	PL_6_2_2021
Bacteria	2	D	55969	46	56015	0.52141	OC_8_12_2020
Eukaryota	2759	D	25036	46	25082	0.23348	OC_8_12_2020
Archaea	2157	D	28	0	28	2.6e-4	OC_8_12_2020
Viruses	10239	D	26299	4	26303	0.24484	OC_8_12_2020
Bacteria	2	D	1890902	2643	1893545	0.51608	ESC_7_12_2021
Eukaryota	2759	D	545429	872	546301	0.14889	ESC_7_12_2021
Archaea	2157	D	954	0	954	2.6e-4	ESC_7_12_2021
Viruses	10239	D	1228102	215	1228317	0.33477	ESC_7_12_2021
Bacteria	2	D	2186974	2017	2188991	0.84458	PL_4_28_2021
Eukaryota	2759	D	5585	42	5627	0.00217	PL_4_28_2021
Archaea	2157	D	2523	1	2524	9.7e-4	PL_4_28_2021
Viruses	10239	D	394597	70	394667	0.15227	PL_4_28_2021
Bacteria	2	D	549625	691	550316	0.61621	HTP_2_7_21
Eukaryota	2759	D	53330	348	53678	0.06011	HTP_2_7_21
Archaea	2157	D	357	0	357	4e-4	HTP_2_7_21
Viruses	10239	D	288624	84	288708	0.32328	HTP_2_7_21
Bacteria	2	D	840421	530	840951	0.83972	PL_3_14_2021
Eukaryota	2759	D	24002	215	24217	0.02418	PL_3_14_2021
Archaea	2157	D	515	0	515	5.1e-4	PL_3_14_2021
Viruses	10239	D	135748	33	135781	0.13558	PL_3_14_2021
Eukaryota	2759	D	1079940	1088	1081028	0.71148	HTP_2_10_21
Bacteria	2	D	234782	412	235194	0.15479	HTP_2_10_21
Archaea	2157	D	284	0	284	1.9e-4	HTP_2_10_21
Viruses	10239	D	202843	54	202897	0.13354	HTP_2_10_21
Eukaryota	2759	D	1724639	1551	1726190	0.85072	PL_1_24_21
Bacteria	2	D	249878	853	250731	0.12357	PL_1_24_21
Archaea	2157	D	90	0	90	4e-5	PL_1_24_21
Viruses	10239	D	52083	2	52085	0.02567	PL_1_24_21
Bacteria	2	D	200271	187	200458	0.75439	PL_3_10_2021
Eukaryota	2759	D	21028	171	21199	0.07978	PL_3_10_2021
Archaea	2157	D	334	0	334	0.00126	PL_3_10_2021
Viruses	10239	D	43682	46	43728	0.16456	PL_3_10_2021
Bacteria	2	D	7953676	5171	7958847	0.94408	HTP_6_3_2021
Eukaryota	2759	D	292068	998	293066	0.03476	HTP_6_3_2021
Archaea	2157	D	1062	0	1062	1.3e-4	HTP_6_3_2021
Viruses	10239	D	177229	93	177322	0.02103	HTP_6_3_2021
Bacteria	2	D	518543	207	518750	0.79251	PL_3_22_2021
Eukaryota	2759	D	132865	416	133281	0.20362	PL_3_22_2021
Archaea	2157	D	340	0	340	5.2e-4	PL_3_22_2021
Viruses	10239	D	2150	45	2195	0.00335	PL_3_22_2021
Eukaryota	2759	D	1377500	1217	1378717	0.86732	PL_2_15_21
Bacteria	2	D	190385	191	190576	0.11989	PL_2_15_21
Archaea	2157	D	175	0	175	1.1e-4	PL_2_15_21
Viruses	10239	D	20013	150	20163	0.01268	PL_2_15_21
Viruses	10239	D	185380	15	185395	0.93776	HTP_12_29_2020
Bacteria	2	D	10045	8	10053	0.05085	HTP_12_29_2020
Eukaryota	2759	D	2213	17	2230	0.01128	HTP_12_29_2020
Archaea	2157	D	20	0	20	1e-4	HTP_12_29_2020
Viruses	10239	D	515451	38	515489	0.54698	HTP_1_12_21
Eukaryota	2759	D	235302	563	235865	0.25027	HTP_1_12_21
Bacteria	2	D	190355	225	190580	0.20222	HTP_1_12_21
Archaea	2157	D	497	0	497	5.3e-4	HTP_1_12_21
Bacteria	2	D	203915	146	204061	0.81337	SJ_10_14_2020
Eukaryota	2759	D	15814	64	15878	0.06329	SJ_10_14_2020
Archaea	2157	D	45	0	45	1.8e-4	SJ_10_14_2020
Viruses	10239	D	30887	10	30897	0.12315	SJ_10_14_2020
Bacteria	2	D	146849	125	146974	0.58785	PL_5_4_2021
Eukaryota	2759	D	34295	127	34422	0.13768	PL_5_4_2021
Archaea	2157	D	680	0	680	0.00272	PL_5_4_2021
Viruses	10239	D	67941	1	67942	0.27175	PL_5_4_2021
Bacteria	2	D	1395184	1040	1396224	0.64366	HTP_3_31_2021
Eukaryota	2759	D	764362	934	765296	0.3528	HTP_3_31_2021
Archaea	2157	D	354	0	354	1.6e-4	HTP_3_31_2021
Viruses	10239	D	7307	12	7319	0.00337	HTP_3_31_2021
Bacteria	2	D	842619	647	843266	0.87404	HTP_5_6_2021
Eukaryota	2759	D	58558	229	58787	0.06093	HTP_5_6_2021
Archaea	2157	D	184	0	184	1.9e-4	HTP_5_6_2021
Viruses	10239	D	62518	35	62553	0.06484	HTP_5_6_2021
Bacteria	2	D	201262	214	201476	0.83872	PL_3_15_2021
Eukaryota	2759	D	18572	321	18893	0.07865	PL_3_15_2021
Archaea	2157	D	260	0	260	0.00108	PL_3_15_2021
Viruses	10239	D	19583	4	19587	0.08154	PL_3_15_2021
Bacteria	2	D	1464816	2198	1467014	0.45221	ESC_6_14_2021
Eukaryota	2759	D	809914	1249	811163	0.25005	ESC_6_14_2021
Archaea	2157	D	1087	0	1087	3.4e-4	ESC_6_14_2021
Viruses	10239	D	964598	204	964802	0.29741	ESC_6_14_2021
Bacteria	2	D	4968043	3943	4971986	0.95282	HTP_2_18_21
Eukaryota	2759	D	63246	461	63707	0.01221	HTP_2_18_21
Archaea	2157	D	1416	2	1418	2.7e-4	HTP_2_18_21
Viruses	10239	D	180629	433	181062	0.0347	HTP_2_18_21
Eukaryota	2759	D	2992650	2810	2995460	0.73814	ESC_7_19_2021
Bacteria	2	D	583277	888	584165	0.14395	ESC_7_19_2021
Archaea	2157	D	2111	0	2111	5.2e-4	ESC_7_19_2021
Viruses	10239	D	476008	378	476386	0.11739	ESC_7_19_2021
Bacteria	2	D	41518	42	41560	0.42218	NC_8_14_2020
Eukaryota	2759	D	33837	193	34030	0.34569	NC_8_14_2020
Archaea	2157	D	25	0	25	2.5e-4	NC_8_14_2020
Viruses	10239	D	22824	0	22824	0.23185	NC_8_14_2020
Eukaryota	2759	D	557087	629	557716	0.75121	ESC_9_7_20
Bacteria	2	D	178468	565	179033	0.24115	ESC_9_7_20
Archaea	2157	D	80	0	80	1.1e-4	ESC_9_7_20
Viruses	10239	D	5423	165	5588	0.00753	ESC_9_7_20
Eukaryota	2759	D	740928	585	741513	0.86576	PL_2_7_21
Bacteria	2	D	91258	153	91411	0.10673	PL_2_7_21
Archaea	2157	D	148	0	148	1.7e-4	PL_2_7_21
Viruses	10239	D	23408	3	23411	0.02733	PL_2_7_21
Bacteria	2	D	224693	120	224813	0.7254	NC_9_11_2020
Eukaryota	2759	D	15066	32	15098	0.04872	NC_9_11_2020
Archaea	2157	D	26	0	26	8e-5	NC_9_11_2020
Viruses	10239	D	69959	17	69976	0.22579	NC_9_11_2020
Bacteria	2	D	16346448	13395	16359843	0.92825	ESC_6_9_2021
Eukaryota	2759	D	910932	1735	912667	0.05178	ESC_6_9_2021
Archaea	2157	D	2202	0	2202	1.2e-4	ESC_6_9_2021
Viruses	10239	D	349550	175	349725	0.01984	ESC_6_9_2021
Bacteria	2	D	8312054	4081	8316135	0.9814	HTP_5_24_2021
Eukaryota	2759	D	18888	149	19037	0.00225	HTP_5_24_2021
Archaea	2157	D	1121	1	1122	1.3e-4	HTP_5_24_2021
Viruses	10239	D	137342	67	137409	0.01622	HTP_5_24_2021
Viruses	10239	D	187039	15	187054	0.91276	HTP_9_22_2020
Bacteria	2	D	12733	5	12738	0.06216	HTP_9_22_2020
Eukaryota	2759	D	5109	24	5133	0.02505	HTP_9_22_2020
Archaea	2157	D	5	0	5	2e-5	HTP_9_22_2020
Eukaryota	2759	D	10662645	6769	10669414	0.75091	PL_7_29_2021
Bacteria	2	D	3463146	6664	3469810	0.2442	PL_7_29_2021
Archaea	2157	D	443	0	443	3e-5	PL_7_29_2021
Viruses	10239	D	67441	1610	69051	0.00486	PL_7_29_2021
Bacteria	2	D	809728	710	810438	0.53707	PL_5_31_2021
Eukaryota	2759	D	30076	127	30203	0.02002	PL_5_31_2021
Archaea	2157	D	527	0	527	3.5e-4	PL_5_31_2021
Viruses	10239	D	667785	40	667825	0.44256	PL_5_31_2021
Bacteria	2	D	890216	714	890930	0.39698	PL_1_14_21
Eukaryota	2759	D	748174	899	749073	0.33377	PL_1_14_21
Archaea	2157	D	1825	0	1825	8.1e-4	PL_1_14_21
Viruses	10239	D	602328	101	602429	0.26843	PL_1_14_21
Viruses	10239	D	1439241	197	1439438	0.50213	PL_6_14_2021
Bacteria	2	D	1409569	1255	1410824	0.49215	PL_6_14_2021
Eukaryota	2759	D	13334	117	13451	0.00469	PL_6_14_2021
Archaea	2157	D	2939	2	2941	0.00103	PL_6_14_2021
Bacteria	2	D	367953	574	368527	0.50381	HTP_2_9_21
Eukaryota	2759	D	121923	596	122519	0.1675	HTP_2_9_21
Archaea	2157	D	446	0	446	6.1e-4	HTP_2_9_21
Viruses	10239	D	239916	63	239979	0.32808	HTP_2_9_21
Eukaryota	2759	D	3693268	2512	3695780	0.73499	ESC_3_22_2021
Bacteria	2	D	929489	608	930097	0.18497	ESC_3_22_2021
Archaea	2157	D	760	0	760	1.5e-4	ESC_3_22_2021
Viruses	10239	D	401423	288	401711	0.07989	ESC_3_22_2021
Bacteria	2	D	1360274	1000	1361274	0.59473	ESC_3_17_2021
Eukaryota	2759	D	268422	774	269196	0.11761	ESC_3_17_2021
Archaea	2157	D	1338	0	1338	5.8e-4	ESC_3_17_2021
Viruses	10239	D	656715	380	657095	0.28708	ESC_3_17_2021
Eukaryota	2759	D	4330519	3668	4334187	0.92851	PL_1_27_21
Bacteria	2	D	270699	645	271344	0.05813	PL_1_27_21
Archaea	2157	D	81	0	81	2e-5	PL_1_27_21
Viruses	10239	D	62245	11	62256	0.01334	PL_1_27_21
Viruses	10239	D	1425020	125	1425145	0.745	PL_6_28_2021
Bacteria	2	D	322323	733	323056	0.16888	PL_6_28_2021
Eukaryota	2759	D	160678	431	161109	0.08422	PL_6_28_2021
Archaea	2157	D	3641	0	3641	0.0019	PL_6_28_2021
Bacteria	2	D	1582581	565	1583146	0.76801	PL_3_7_2021
Eukaryota	2759	D	452243	812	453055	0.21979	PL_3_7_2021
Archaea	2157	D	745	0	745	3.6e-4	PL_3_7_2021
Viruses	10239	D	24381	27	24408	0.01184	PL_3_7_2021
Eukaryota	2759	D	74608	137	74745	0.46947	PL_2_10_21
Bacteria	2	D	66016	129	66145	0.41545	PL_2_10_21
Archaea	2157	D	82	0	82	5.2e-4	PL_2_10_21
Viruses	10239	D	18236	2	18238	0.11455	PL_2_10_21
Bacteria	2	D	3732426	2476	3734902	0.72497	HTP_1_31_21
Eukaryota	2759	D	1117461	1377	1118838	0.21718	HTP_1_31_21
Archaea	2157	D	740	0	740	1.4e-4	HTP_1_31_21
Viruses	10239	D	297182	109	297291	0.05771	HTP_1_31_21
Bacteria	2	D	1888242	2945	1891187	0.65262	ESC_6_24_2021
Eukaryota	2759	D	278788	734	279522	0.09646	ESC_6_24_2021
Archaea	2157	D	1290	0	1290	4.5e-4	ESC_6_24_2021
Viruses	10239	D	725649	203	725852	0.25048	ESC_6_24_2021
Bacteria	2	D	4813126	2751	4815877	0.97959	PL_3_29_2021
Eukaryota	2759	D	27188	220	27408	0.00558	PL_3_29_2021
Archaea	2157	D	4632	2	4634	9.4e-4	PL_3_29_2021
Viruses	10239	D	68256	49	68305	0.01389	PL_3_29_2021
Bacteria	2	D	5668493	5118	5673611	0.9111	HTP_1_14_21
Eukaryota	2759	D	51523	286	51809	0.00832	HTP_1_14_21
Archaea	2157	D	1265	1	1266	2e-4	HTP_1_14_21
Viruses	10239	D	500270	255	500525	0.08038	HTP_1_14_21
Bacteria	2	D	1396915	762	1397677	0.78291	PL_2_21_21
Eukaryota	2759	D	323441	549	323990	0.18148	PL_2_21_21
Archaea	2157	D	707	0	707	4e-4	PL_2_21_21
Viruses	10239	D	62808	58	62866	0.03521	PL_2_21_21
Bacteria	2	D	2160198	964	2161162	0.95104	PL_3_3_2021
Eukaryota	2759	D	47711	312	48023	0.02113	PL_3_3_2021
Archaea	2157	D	1183	0	1183	5.2e-4	PL_3_3_2021
Viruses	10239	D	62038	21	62059	0.02731	PL_3_3_2021
Bacteria	2	D	755291	968	756259	0.55762	ESC_8_10_20
Eukaryota	2759	D	371236	567	371803	0.27414	ESC_8_10_20
Archaea	2157	D	527	0	527	3.9e-4	ESC_8_10_20
Viruses	10239	D	227525	119	227644	0.16785	ESC_8_10_20
Bacteria	2	D	1745116	777	1745893	0.88163	PL_3_24_2021
Eukaryota	2759	D	194406	591	194997	0.09847	PL_3_24_2021
Archaea	2157	D	1035	0	1035	5.2e-4	PL_3_24_2021
Viruses	10239	D	38347	30	38377	0.01938	PL_3_24_2021
Bacteria	2	D	4077372	3494	4080866	0.79943	HTP_1_21_21
Eukaryota	2759	D	83719	331	84050	0.01647	HTP_1_21_21
Archaea	2157	D	760	0	760	1.5e-4	HTP_1_21_21
Viruses	10239	D	938555	492	939047	0.18396	HTP_1_21_21
Eukaryota	2759	D	559252	625	559877	0.57967	PL_5_10_2021
Bacteria	2	D	207048	245	207293	0.21462	PL_5_10_2021
Archaea	2157	D	192	0	192	2e-4	PL_5_10_2021
Viruses	10239	D	198481	14	198495	0.20551	PL_5_10_2021
Eukaryota	2759	D	21374317	10772	21385089	0.98369	PL_2_1_21
Bacteria	2	D	226303	813	227116	0.01045	PL_2_1_21
Archaea	2157	D	340	0	340	2e-5	PL_2_1_21
Viruses	10239	D	127151	31	127182	0.00585	PL_2_1_21
Viruses	10239	D	1072543	84	1072627	0.55575	PL_7_25_2021
Eukaryota	2759	D	603974	936	604910	0.31341	PL_7_25_2021
Bacteria	2	D	245573	579	246152	0.12754	PL_7_25_2021
Archaea	2157	D	6377	1	6378	0.0033	PL_7_25_2021
Bacteria	2	D	1891691	3437	1895128	0.7658	ESC_11_23_20
Eukaryota	2759	D	23802	250	24052	0.00972	ESC_11_23_20
Archaea	2157	D	1046	1	1047	4.2e-4	ESC_11_23_20
Viruses	10239	D	554144	343	554487	0.22406	ESC_11_23_20
Bacteria	2	D	932953	1058	934011	0.93504	SB_9_24_2020
Eukaryota	2759	D	5527	39	5566	0.00557	SB_9_24_2020
Archaea	2157	D	196	0	196	2e-4	SB_9_24_2020
Viruses	10239	D	59087	37	59124	0.05919	SB_9_24_2020
Bacteria	2	D	1697781	1934	1699715	0.52674	HTP_7_8_2021
Eukaryota	2759	D	18012	192	18204	0.00564	HTP_7_8_2021
Archaea	2157	D	944	0	944	2.9e-4	HTP_7_8_2021
Viruses	10239	D	1507632	372	1508004	0.46733	HTP_7_8_2021
Eukaryota	2759	D	343327	663	343990	0.43343	HTP_2_15_21
Bacteria	2	D	244788	364	245152	0.30889	HTP_2_15_21
Archaea	2157	D	340	0	340	4.3e-4	HTP_2_15_21
Viruses	10239	D	204120	47	204167	0.25725	HTP_2_15_21
Viruses	10239	D	1315928	204	1316132	0.57841	HTP_7_13_2021
Bacteria	2	D	637884	683	638567	0.28064	HTP_7_13_2021
Eukaryota	2759	D	318442	979	319421	0.14038	HTP_7_13_2021
Archaea	2157	D	1307	0	1307	5.7e-4	HTP_7_13_2021
Bacteria	2	D	1587695	3994	1591689	0.74269	HTP_7_15_2021
Eukaryota	2759	D	65369	525	65894	0.03075	HTP_7_15_2021
Archaea	2157	D	1404	2	1406	6.6e-4	HTP_7_15_2021
Viruses	10239	D	483450	690	484140	0.2259	HTP_7_15_2021
Viruses	10239	D	1937306	278	1937584	0.87473	ESC_8_24_20
Eukaryota	2759	D	152904	232	153136	0.06913	ESC_8_24_20
Bacteria	2	D	123988	109	124097	0.05602	ESC_8_24_20
Archaea	2157	D	250	0	250	1.1e-4	ESC_8_24_20
Eukaryota	2759	D	6494374	3678	6498052	0.94228	HTP_3_21_2021
Bacteria	2	D	396361	408	396769	0.05754	HTP_3_21_2021
Archaea	2157	D	124	0	124	2e-5	HTP_3_21_2021
Viruses	10239	D	1001	176	1177	1.7e-4	HTP_3_21_2021
Viruses	10239	D	102482	21	102503	0.84224	SJ_11_4_2020
Bacteria	2	D	16109	7	16116	0.13242	SJ_11_4_2020
Eukaryota	2759	D	3010	29	3039	0.02497	SJ_11_4_2020
Archaea	2157	D	43	0	43	3.5e-4	SJ_11_4_2020
Bacteria	2	D	2798863	2090	2800953	0.88331	HTP_2_2_21
Eukaryota	2759	D	67020	237	67257	0.02121	HTP_2_2_21
Archaea	2157	D	423	0	423	1.3e-4	HTP_2_2_21
Viruses	10239	D	302202	133	302335	0.09534	HTP_2_2_21
Viruses	10239	D	59628	10	59638	0.58428	OC_11_4_2020
Bacteria	2	D	22637	36	22673	0.22213	OC_11_4_2020
Eukaryota	2759	D	19718	29	19747	0.19346	OC_11_4_2020
Archaea	2157	D	13	0	13	1.3e-4	OC_11_4_2020
Viruses	10239	D	510195	123	510318	0.58039	HTP_3_2_21
Bacteria	2	D	259856	325	260181	0.29591	HTP_3_2_21
Eukaryota	2759	D	108137	317	108454	0.12335	HTP_3_2_21
Archaea	2157	D	310	0	310	3.5e-4	HTP_3_2_21
Eukaryota	2759	D	1381003	1537	1382540	0.66321	ESC_3_8_2021
Bacteria	2	D	578040	953	578993	0.27774	ESC_3_8_2021
Archaea	2157	D	494	0	494	2.4e-4	ESC_3_8_2021
Viruses	10239	D	122566	30	122596	0.05881	ESC_3_8_2021
Bacteria	2	D	642209	413	642622	0.37753	PL_1_12_21
Eukaryota	2759	D	260043	409	260452	0.15301	PL_1_12_21
Archaea	2157	D	1134	0	1134	6.7e-4	PL_1_12_21
Viruses	10239	D	797847	114	797961	0.46879	PL_1_12_21
Bacteria	2	D	124243	54	124297	0.76224	SJ_9_30_2020
Eukaryota	2759	D	13030	25	13055	0.08006	SJ_9_30_2020
Archaea	2157	D	25	0	25	1.5e-4	SJ_9_30_2020
Viruses	10239	D	25684	5	25689	0.15754	SJ_9_30_2020
Eukaryota	2759	D	165427	138	165565	0.80957	JWPCP_10_13_2020
Bacteria	2	D	35507	18	35525	0.17371	JWPCP_10_13_2020
Archaea	2157	D	18	0	18	9e-5	JWPCP_10_13_2020
Viruses	10239	D	3400	0	3400	0.01663	JWPCP_10_13_2020
Viruses	10239	D	1112576	58	1112634	0.87182	ESC_9_21_20
Bacteria	2	D	103970	127	104097	0.08157	ESC_9_21_20
Eukaryota	2759	D	58898	310	59208	0.04639	ESC_9_21_20
Archaea	2157	D	276	0	276	2.2e-4	ESC_9_21_20
Viruses	10239	D	182042	7	182049	0.9369	PL_12_22_2020
Bacteria	2	D	9208	11	9219	0.04744	PL_12_22_2020
Eukaryota	2759	D	2953	16	2969	0.01528	PL_12_22_2020
Archaea	2157	D	72	0	72	3.7e-4	PL_12_22_2020
Bacteria	2	D	2448434	785	2449219	0.84162	PL_1_18_21
Eukaryota	2759	D	398058	1210	399268	0.1372	PL_1_18_21
Archaea	2157	D	3727	0	3727	0.00128	PL_1_18_21
Viruses	10239	D	57909	8	57917	0.0199	PL_1_18_21
Eukaryota	2759	D	168010	247	168257	0.42535	PL_5_12_2021
Bacteria	2	D	143767	77	143844	0.36363	PL_5_12_2021
Archaea	2157	D	514	0	514	0.0013	PL_5_12_2021
Viruses	10239	D	82959	1	82960	0.20972	PL_5_12_2021
Viruses	10239	D	1748773	129	1748902	0.59255	ESC_5_31_2021
Eukaryota	2759	D	837850	1042	838892	0.28423	ESC_5_31_2021
Bacteria	2	D	362131	451	362582	0.12285	ESC_5_31_2021
Archaea	2157	D	1118	0	1118	3.8e-4	ESC_5_31_2021
Bacteria	2	D	1862624	1184	1863808	0.94601	PL_3_21_2021
Eukaryota	2759	D	61051	345	61396	0.03116	PL_3_21_2021
Archaea	2157	D	575	0	575	2.9e-4	PL_3_21_2021
Viruses	10239	D	44379	21	44400	0.02254	PL_3_21_2021
Bacteria	2	D	10676188	6961	10683149	0.97223	HTP_1_28_21
Eukaryota	2759	D	87568	619	88187	0.00803	HTP_1_28_21
Archaea	2157	D	1976	2	1978	1.8e-4	HTP_1_28_21
Viruses	10239	D	214789	227	215016	0.01957	HTP_1_28_21
Bacteria	2	D	1384105	1415	1385520	0.83456	ESC_12_21_20
Eukaryota	2759	D	86719	865	87584	0.05276	ESC_12_21_20
Archaea	2157	D	3882	3	3885	0.00234	ESC_12_21_20
Viruses	10239	D	183012	178	183190	0.11034	ESC_12_21_20
Bacteria	2	D	3123560	1891	3125451	0.82951	ESC_1_18_21
Eukaryota	2759	D	556303	1112	557415	0.14794	ESC_1_18_21
Archaea	2157	D	706	0	706	1.9e-4	ESC_1_18_21
Viruses	10239	D	84217	25	84242	0.02236	ESC_1_18_21
Viruses	10239	D	395748	15	395763	0.56807	PL_4_14_2021
Bacteria	2	D	269029	342	269371	0.38665	PL_4_14_2021
Eukaryota	2759	D	29717	333	30050	0.04313	PL_4_14_2021
Archaea	2157	D	1494	1	1495	0.00215	PL_4_14_2021
Bacteria	2	D	18082103	12064	18094167	0.96731	HTP_5_18_2021
Eukaryota	2759	D	359848	1264	361112	0.01931	HTP_5_18_2021
Archaea	2157	D	2401	1	2402	1.3e-4	HTP_5_18_2021
Viruses	10239	D	247504	413	247917	0.01325	HTP_5_18_2021
Viruses	10239	D	192078	47	192125	0.79879	SB_11_5_2020
Eukaryota	2759	D	38356	43	38399	0.15965	SB_11_5_2020
Bacteria	2	D	9985	4	9989	0.04153	SB_11_5_2020
Archaea	2157	D	7	0	7	3e-5	SB_11_5_2020
Viruses	10239	D	3370657	177	3370834	0.93255	PL_7_5_2021
Bacteria	2	D	204331	588	204919	0.05669	PL_7_5_2021
Eukaryota	2759	D	36554	371	36925	0.01022	PL_7_5_2021
Archaea	2157	D	1969	2	1971	5.5e-4	PL_7_5_2021
Bacteria	2	D	2300923	2651	2303574	0.58339	ESC_5_10_2021
Eukaryota	2759	D	35955	298	36253	0.00918	ESC_5_10_2021
Archaea	2157	D	1266	1	1267	3.2e-4	ESC_5_10_2021
Viruses	10239	D	1607019	475	1607494	0.40711	ESC_5_10_2021
Bacteria	2	D	3062098	4321	3066419	0.79133	PL_7_19_2021
Eukaryota	2759	D	188282	502	188784	0.04872	PL_7_19_2021
Archaea	2157	D	2376	0	2376	6.1e-4	PL_7_19_2021
Viruses	10239	D	617241	208	617449	0.15934	PL_7_19_2021
Viruses	10239	D	622077	22	622099	0.74198	HTP_5_13_2021
Bacteria	2	D	187330	127	187457	0.22358	HTP_5_13_2021
Eukaryota	2759	D	28212	162	28374	0.03384	HTP_5_13_2021
Archaea	2157	D	501	0	501	6e-4	HTP_5_13_2021
Bacteria	2	D	13410	14	13424	0.53164	JWPCP_8_18_2020
Eukaryota	2759	D	3646	15	3661	0.14499	JWPCP_8_18_2020
Archaea	2157	D	14	0	14	5.5e-4	JWPCP_8_18_2020
Viruses	10239	D	8150	0	8150	0.32277	JWPCP_8_18_2020
Bacteria	2	D	86060	89	86149	0.80718	JWPCP_9_01_2020
Eukaryota	2759	D	10253	30	10283	0.09635	JWPCP_9_01_2020
Archaea	2157	D	97	0	97	9.1e-4	JWPCP_9_01_2020
Viruses	10239	D	10197	1	10198	0.09555	JWPCP_9_01_2020
Bacteria	2	D	4547077	19200	4566277	0.66774	PL_6_21_2021
Eukaryota	2759	D	1392345	1695	1394040	0.20385	PL_6_21_2021
Archaea	2157	D	2879	0	2879	4.2e-4	PL_6_21_2021
Viruses	10239	D	874267	953	875220	0.12799	PL_6_21_2021
Bacteria	2	D	934108	5776	939884	0.85299	ESC_10_5_20
Eukaryota	2759	D	54683	649	55332	0.05022	ESC_10_5_20
Archaea	2157	D	1131	1	1132	0.00103	ESC_10_5_20
Viruses	10239	D	104582	937	105519	0.09576	ESC_10_5_20
Eukaryota	2759	D	140707	305	141012	0.31022	ESC_10_12_20
Bacteria	2	D	123439	425	123864	0.27249	ESC_10_12_20
Archaea	2157	D	77	0	77	1.7e-4	ESC_10_12_20
Viruses	10239	D	189585	20	189605	0.41712	ESC_10_12_20
Eukaryota	2759	D	4657314	2780	4660094	0.90594	ESC_9_14_20
Bacteria	2	D	237574	597	238171	0.0463	ESC_9_14_20
Archaea	2157	D	248	0	248	5e-5	ESC_9_14_20
Viruses	10239	D	245265	175	245440	0.04771	ESC_9_14_20
Bacteria	2	D	6152555	4168	6156723	0.96836	HTP_4_26_2021
Eukaryota	2759	D	31064	118	31182	0.0049	HTP_4_26_2021
Archaea	2157	D	737	0	737	1.2e-4	HTP_4_26_2021
Viruses	10239	D	169170	60	169230	0.02662	HTP_4_26_2021
